..ww....w..w.w.
w....ww.w.w....
.w.ww.......w.w
..ww..wAw.w.w..
w....w..w..w..w
.w.ww..w..w.w..
.....w..w....w.
w.w.w.w.w.w.ww.
...w....w.ww..w
ww.w.ww.w...w..
...w.w..w.w...w
.w..w..w..w.w..
..w..w..w.w..w.
.w..w..w.w..w..
..w..w.w...wx.w